Xu, Xu, Xu, Xu, Xu, Xu, Xu, Xu, Xu, Xu, Xu, Xu, Xu, Xu, Xu, Xu, Xu, Xu, Xu, Xu, Xu, Xu, Xu, Xu, Xu, Xu, Xu, Xu, Xu, Xu, Xu, Xu, Xos, Xu, Xu, Xu, Xu, Xu, Xu, Xu, Xu, Xu, Xu
Xu, Xu, Xu, Xu, Xos, Xos, Xos, Xu, Xos, Xu, Xos, Xos, Xos, Xu, Xu, Xu, Xos, Xu, Xos, Xos, Xos, Xu, Xos, Xos, Xos, Xu, Xos, Xos, Xos, Xos, Xos, Xos, Xos, Xu, Xos, Xos, Xos, Xos, Xos, Xu, Xu, Xu, Xu
Xu, Xu, Xos, Xos, Irs, Irs, Irs, Xos, Irs, Xos, Irs^Vhc, Irs, Irs, Xos, Xu, Xos, Xos, Xos, Cud, Ur, Ur, Xos, Cud, Ur, Ur, Xos, Xos, Xos, Irs, Xos, Irs, Irs, Irs, Xos, Irs, Irs, Irs, Irs, Irs, Xos, Xos, Xu, Xu
Xu, Xu, Xos, Irs, Cha, Cha, Cha, Irs, Irs^Vhc, Irs, Irs, Irs, Cf, Xos, Xu, Xos, Ur, Ur, Ias, Ias, Ias, Ur, Ias, Ias, Cf, Xos, Xos, Irs, Irs, Irs^Vhc, Irs, Irs, Irs, Irs^Vhc, Irs, Irs, Cha, Irs, Irs, Irs^Vhc, Irs, Xos, Xu
Xu, Xu, Xos, Irs, Cha, 3 Kha, Cha, Irs, Irs, Irs, Irs, Irs, Xos, Xos, Xu, Xos, Cf, Ias, Ur, Ur, Ur, Ias, Ur, Ur, Xos, Xos, Xos, Cf, Irs, Irs, Irs, Irs, Irs, Irs, Irs, Cha, 1 Kha, Cha, Irs, Irs, Irs, Xos, Xu
Xu, Xu, Xos, Irs, Irs, Cha, Irs, Irs, Irs, Irs, Cf, Xos, Xu, Xu, Xu, Xos, Xos, Ur, Xos, Cud, Xos, Xos, Xos, Xos, Xu, Xu, Xu, Xos, Xos, Irs, Xos, Cf, Irs, Irs, Irs, Cha, Cha, Cha, Irs, Irs, Irs, Xos, Xu
Xu, Xos, Irs, Irs, Irs, Irs, Irs^Vhc, Irs, Irs, Irs, Xos, Xos, Xu, Xu, Uue^Tf, Xu, Xu, Xos, Xu, Xos, Xu, Xu, Xu, Xu, Xu, Xu, Xu, Xu, Xu, Xos, Xu, Xos, Xos, Irs, Cf, Irs, Irs, Irs, Irs, Irs, Irs^Vhc, Xos, Xu
Xu, Xos, Irs, Irs^Vhc, Irs, Irs, Irs, Irs, Xos, Xos, Xu, Xu, Uhe, Uue, Ias, Ias, Ias, Xu, Uue^Tf, Xu, Xu, Xu, Xu, Xu, Gll^Vhr, Hhd, Md, Xu, Xu, Xu, Uh, Xu, Xu, Xos, Xos, Xos, Xos, Irs, Irs, Irs, Irs, Xos, Xu
Xu, Xos, Irs, Irs, Irs, Irs, Cf, Xos, Xu, Xu, Ias, Ias, Ias, Qlf, Qlf, Uhe, Ias, Uue, Gll^Fts, Gll^Fts, Ias, Md, Gll^Fts, Gll, Ias, Gll^Feth, Ww, Xu, Uu^Tf, Uu^Vu, Uu, Ur, Uu, Xu, Xu, Xu, Xos, Irs, Irs^Vhc, Irs, Irs, Xos, Xu
Xu, Xos, Irs, Irs^Vhc, Irs, Irs, Xos, Xos, Xu, Xu, Qlf, Uue, Ss^Bh\, Ss, Wwf, Uue, Ww, Ias, Ias, Ias, Uue, Ias, Ias, Ias, Ww, Ww^Bh\, Ur, Sm, Sm, Uu^Tf, Ur, Ur, Uu^Tf, Uh, Xu, Xu, Xos, Irs, Irs, Irs, Irs, Xos, Xu
Xu, Xos, Irs, Irs, Cf, Xos, Xu, Xu, Xu, Uhe, Qlf, Wwf, Ias, Ias, Ias, Wwf, Qlf, Ww, Wwf, Uue, Ss, Ww, Ww, Ww, Md, Xu, Uu^Tf, Ur, Uu, Wwf, Ur, Uu^Tf, Uu, Uh, Ur, Xu, Xu, Xos, Cf, Irs, Irs, Xos, Xu
Xu, Xos, Xos, Irs, Xos, Xos, Xu, Xu, Gll^Fts, Gll^Fts, Wwf, Wwf, Ias, Uue^Vhr, Ias, Uue, Ias, Qlf, Uhe, Wwf, Gll^Fts, Hhd, Rp, Gll^Fts, Gll^Fts, Xu, Xu, Ur, Uu, Wwf, Sm^Bw/r, Ur, Ur, Ur, Ha, Xu, Xu, Xos, Xos, Irs, Xos, Xos, Xu
Xu, Xu, Xu, Xos, Xu, Xu, Rd, Hhd, Ur, Ur, Ss, Ur, Uue, Qlf, Qlf, Ias, Gll^Ftp, Ias, Ias, Uue, Rp, Rp, Gll^Vhcr, Rp, Rp, Hhd, Xu, Ur, Ur, Ur, Sm, Sm, Xu, Aa, Rra, Rra, Rra, Xu, Xu, Xos, Xu, Xu, Xu
Xu, Xu, Xu, Xu, Xu, Rd^Vc, Gll^Fts, Rd, Ur, Rd^Dr, Ss, Ur, Ias, Uhe, Gll, Gll^Ftp, Ss, Gll, Ias, Rp, Xoc, Xoc, Xoc, Gll, Rp, Gll, Gll^Ftp, Xu, Xu, Xu, Aa^Fma, Wwf, Wwf, Xu, Aa^Fma, Aa^Vaa, Rra, Aa^Fma, Xu, Xu, Rr, Xu, Xu
Xu, Xu, Xu, Xu, Xu, Hhd, Ur, Ur, Ds, Ds, Wwf, Ur, Gll, Ias, Ias, Ss, Uue, Uue^Tf, Ias, Xoc, Rrc, Rrc, Rrc, Xoc, Rra, Gll^Ftp, Gll^Dr, Gll, Rra, Aa, Ha, Rra, Rra, Ww, Rra, Rra, Rra, Ha, Aa^Fma, Xu, Xu, Xu, Xu
Xu, Xu, Xu, Xu, Mm^Xm, Mm^Xm, Wwf, Wwf, Ss, Wwf, Ur, Ur, Uhe, Gll^Ftp, Ss, Ias, Ias, Ias, Cf, Cf, Rrc, Rrc^Vhc, Rrc, Cf, Cf, Rra, Rra, Rra, Aa, Rra, Rra, Aa, Rra, Ww^Bsb/, Aa^Fma, Aa^Fma, Rra, Ms, Aa, Xu, Xu, Xu, Xu
Xu, Xu, Rr, Xu, Mm^Xm, Wo, Wwf, Mm^Xm, Ss, Ur, Re, Uue, Qlf, Qlf, Xoc, Xoc, Cf, Cf, Wwf, Wwf, Wwf, Wwf, Wwf, Rrc, Rrc, Cf, Cf, Xoc, Xoc, Ha, Aa^Fma, Rra, Ai, Ww, Ha, Rra, Aa, Rra, Xu, Xu, Rr, Xu, Xu
Xu, Xu, Xu, Xu, Xu, Ww^Vm, Mm^Xm, Mm^Xm, Ww, Ds, Ds, Re, Gll^Feth, Xoc, Rrc, Rrc, Wwf, Wwf, Hh, Rrc, Rrc, Gs^Fms, Rrc, Wwf, Wwf, Rrc, Rrc, Rrc, Rrc, Xoc, Aa, Rra, Wwf, Rra, Rra, Rra, Ur, Xu, Xu, Xu, Xu, Xu, Xu
Xu, Xu, Rr, Xu, Xu, Xu, Ur, Re, Re, Ww, Ww, Re, Re, Xoc, Rrc, Rrc^Vhc, Wwf, Gs^Fms, Ch, Ch, Ch, Ch, Ch, Ch, Ch, Wwf, Rrc, Rrc^Vhc, Rrc, Xoc, Rra, Rra, Wwf, Aa^Vaa, Aa, Ur, Ur, Ur, Xos, Xos, Xos, Xu, Xu
Xu, Xu, Xos, Xos, Xos, Ur, Ur, Ur, Re, Gll^Ftp, Gll^Ftp, Ww, Re, Xoc, Cf, Wwf, Rrc, Rrc, Ch, 4 Kh, Rrc, Rrc^Vhc, Rrc, 6 Kh, Ch, Wwf, Wwf, Rrc, Cf, Xoc, Rra, Aa, Ai, Aa^Fma, Xu, Xu, Xos, Xos, Wwg, Cf, Xos, Xos, Xu
Xu, Xos, Xos, Cf, Wwg, Xos, Xos, Xu, Xu, Re, Gll, Ww, Gll, Re, Cf, Wwf, Hh, Ch, Gs^Fms, Hh, Wwf, Wwf, Wwf, Gll^Fp, Rrc^Vhc, Ch, Wwf, Rrc, Cf, Rra, Aa^Fma, Ww, Rra, Rra, Md^Xm, Xu, Xos, Cf, Wwg, Cf, Cf, Xos, Xu
Xu, Xos, Cf, Cf, Wwg, Cf, Xos, Xu, Xu, Re, Re, Ww, Gll^Ftp, Re, Cf, Wwf, Wwf, Ch, Rrc^Vhc, Rrc, Wwf, Kh, Wwf, Rrc, Rrc, Ch, Hh, Wwf, Cf, Rra, Aa, Ww, Rrc, Gs^Fms, Md, Xu, Xos, Cf, Wwg, Cf, Xos, Xos, Xu
Xu, Xos, Xos, Cf, Wwg, Cf, Xos, Xu, Gs^Ft, Dd, Dd, Ww, Re, Re, Cf, Rrc, Wwf, Ch, Ch, Rrc, Rrc, Wwf, Rrc, Hh, Ch, Ch, Rrc, Wwf, Cf, Rra, Ias, Wwf, Ds, Rr, Rr, Xu, Xu, Xos, Xos, Cf, Xos, Xos, Xu
Xu, Xos, Xos, Cf, Xos, Xos, Ur, Xu, Gs^Ft, Dd^Vda, Wwf, Ww, Dd, Xoc, Rrc, Rrc, Rrc, Wwf, Ch, 2 Kh, Ch, Rrc^Vhc, Ch, 8 Kh, Ch, Rrc, Wwf, Wwf, Rrc, Xoc, Ias, Wwf, Ds, Wwf, Wwf, Rp, Rp, Ur, Ur, Xos, Xu, Xu, Xu
Xu, Xu, Rr, Xos, Xu, Ur, Hd, Rd, Rd, Hd, Wwf, Dd, Ias, Xoc, Rrc, Rrc^Vhc, Rrc, Wwf, Wwf, Ch, Rrc, Ch, Rrc, Ch, Hh, Gs^Fms, Wwf, Rrc^Vhc, Rrc, Xoc, Mm, Wwf, Ww, Gs^Fms, Wwf, Gs^Fms, Hh, Rp, Xu, Xu, Rr, Xu, Xu
Xu, Xu, Xu, Xu, Xu, Xu, Mdd, Gs^Ft, Rd, Wwf, Rd, Rd, Rd, Xoc, Xoc, Rrc, Cf, Rrc, Rrc, Wwf, Wwf, Gs^Fms, Wwf, Rrc, Wwf, Wwf, Cf, Rrc, Xoc, Xoc, Wwf, Wwf, Gs^Vhc, Ww, Wo, Wwf, Gs, Rp, Xu, Xu, Xu, Xu, Xu
Xu, Xu, Rr, Xu, Gs^Ft, Dd, Rd, Gs^Ft, Dd, Wwf, Gs^Ft, Gs^Ft, Gs, Rd, Rd, Xoc, Rd, Cf, Cf, Rrc, Rrc, Wwf, Rrc, Wwf, Cf, Cf, Rp, Xoc, Ias, Ias, Wwf, Gs^Fms, Ds, Wwf, Wwf, Ss, Rp, Rp, Xu, Xu, Xu, Xu, Xu
Xu, Xu, Xu, Xu, Dd, Rd, Dd^Vda, Rd, Dd, Ww, Dd, Mdd, Hd, Gs, Gs^Ft, Rd, Hh, Rd, Rd, Cf, Rrc, Rrc^Vhc, Rrc, Cf, Rp, Rp, Gs^Fms, Rp, Rp, Ias, Ss, Gs, Gs, Ds, Wwf, Rp, Gs, Gs, Xu, Xu, Rr, Xu, Xu
Xu, Xu, Xu, Xu, Xu, Hd, Gs^Ft, Gs^Ft, Rd, Ww, Ww, Dd, Wwf, Wwf, Wwf, Gs^Ft, Hh, Gs, Rp, Xoc, Xoc, Rrc, Xoc, Xoc, Rp, Gs, Wwf, Mm, Wwf, Ss, Rp, Gs^Fms, Rp, Rp, Ww, Hh, Gs^Fms, Gs^Vhc, Xu, Xu, Xu, Xu, Xu
Xu, Xu, Xu, Xu, Xu, Rd, Rd, Rd, Gs^Ft, Gs^Ft, Xu, Ww, Xu, Hhd, Gs, Wwf, Ww, Gs^Vht, Rp, Gs, Hh, Xoc, Gs, Gs, Wwf, Wwf, Gs^Fms, Wwf, Gs, Gs, Gs^Vhc, Rp, Wwf, Ww, Gs, Gs^Fms, Mm, Gs, Xu, Xu, Xu, Xu, Xu
Xu, Xu, Xos, Xos, Xos, Xu, Xu, Dd, Gs, Hhd, Uu, Xu, Uu, Uu, Ur, Xu, Xu, Ww, Ss, Rp, Gs^Fms, Gs^Fms, Rp, Rp, Wwf, Gs^Fms, Hh, Gs, Ds, Gs^Fms, Wwf, Wwf, Rp, Gs, Cer, Gs, Xu, Xu, Xos, Xos, Xos, Xu, Xu
Xu, Xos, Irs, Cf, Irs, Xos, Xu, Xu, Uh, Ur, Ur, Ur, Ur, Ur, Uh, Uu^Tf, Xu, Wwf, Wwf, Rp, Rp, Rp, Ww, Wwf, Wo, Wwf, Ww, Ds, Ww, Ww, Gs, Rp, Gs^Fms, Gs, Xu, Xu, Xu, Xos, Irs, Cf, Irs, Xos, Xu
Xu, Xos, Irs^Vhc, Irs, Irs, Xos, Xos, Xu, Xu, Uh, Sm, Sm, Ur, Sm, Sm, Uu, Uh, Ss, Gs^Fms, Ww, Ww, Ww, Ds, Ds, Rb, Rb, Rp, Ww, Hh, Gs, Ias, Rp, Hh, Gs^Fms, Xu, Xu, Xos, Xos, Irs, Irs, Irs, Xos, Xu
Xu, Xos, Irs, Irs, Irs, Cf, Xos, Xu, Xu, Uu^Tf, Uu^Vu, Sm, Ur, Uu, Ur, Ur, Uu, Hh, Rb, Rb, Rb, Gs^Fms, Rb, Rb, Gs, Gs, Rp, Gs^Fms, Gs^Fms, Ias, Rp, Rp, Gs, Xu, Xu, Xos, Cf, Irs, Irs, Irs^Vhc, Irs, Xos, Xu
Xu, Xos, Irs, Irs, Irs, Irs, Xos, Xu, Xos, Xu, Xu, Uh, Uu^Tf, Uu, Xu, Uu^Tf, Xu, Md^Xm, Md^Xm, Ss, Ss, Rb, Mm, Hh, Xu, Gs^Fms, Hh, Rp, Rp, Rp, Cer, Gs^Fms, Xu, Xu, Xos, Xos, Irs, Irs, Irs, Irs, Irs, Xos, Xu
Xu, Xos, Irs, Irs^Vhc, Irs, Irs, Irs, Xos, Cf, Xos, Xos, Xu, Xu, Xu, Xu, Xu, Xu, Xu, Xu, Xu, Xu, Xu, Xu, Xu, Xos, Xu, Xu, Gs^Vhc, Wwf, Wwf, Xu, Xu, Xos, Xos, Irs, Irs^Vhc, Irs, Irs, Irs, Irs, Irs, Xos, Xu
Xu, Xos, Irs, Irs, Cha, Irs, Irs, Irs, Irs, Irs, Irs, Xos, Xos, Xos, Xos, Xu, Xu, Xos, Xos, Xos, Xos, Xu, Xos, Xos, Cud, Xos, Xos, Xu, Xu, Xu, Xu, Xos, Cf, Irs, Irs, Irs, Irs, Irs, Irs^Vhc, Irs, Xos, Xos, Xu
Xu, Xos, Irs, Cha, 5 Kha, Cha, Irs, Irs, Irs^Vhc, Irs, Irs, Irs, Irs, Irs^Vhc, Irs, Xos, Xos, Xos, Cf, Ur, Ur, Xos, Ur, Ur, Ur, Ur, Ur, Xos, Xu, Xu, Xos, Xos, Irs, Irs, Irs, Irs, Cha, Cha, Cha, Irs, Xos, Xu, Xu
Xos, Xos, Irs, Cha, Cha, Cha, Irs, Irs, Irs, Irs, Irs, Irs^Vhc, Irs, Irs, Irs, Cf, Xos, Xos, Ur, Ias, Ias, Ur, Ias, Ias, Ias, Ur, Ur, Xos, Xos, Xos, Cf, Irs, Irs^Vhc, Irs, Irs, Irs^Vhc, Cha, 7 Kha, Cha, Irs, Xos, Xu, Xu
Xu, Xos, Xos, Irs, Irs, Irs, Irs, Irs, Irs, Irs, Irs, Irs, Irs, Irs, Irs, Irs, Xos, Xos, Ur, Ur, Ur, Ias, Ur, Ur, Ur, Ias, Ias, Ur, Xos, Xos, Irs, Irs, Irs, Irs, Irs, Irs, Irs, Cha, Irs, Irs, Xos, Xu, Xu
Xu, Xu, Xu, Xos, Xos, Irs, Xos, Irs, Xos, Xos, Xos, Irs, Xos, Xos, Xos, Xos, Xu, Xos, Xos, Ur, Cud, Ur, Xos, Ur, Cud, Ur, Ur, Cf, Xos, Xos, Xos, Irs, Xos, Xos, Xos, Xos, Xos, Irs, Xos, Xos, Xu, Xu, Xu
Xu, Xu, Xu, Xu, Xu, Xos, Xu, Xos, Xu, Xu, Xu, Xos, Xu, Xu, Xu, Xu, Xu, Xos, Xu, Xos, Xu, Xos, Xu, Xos, Xos, Xos, Xos, Xos, Xu, Xu, Xu, Xos, Xu, Xu, Xu, Xu, Xu, Xos, Xu, Xu, Xu, Xu, Xu
Xu, Xu, Xu, Xu, Xu, Xu, Xu, Xu, Xu, Xu, Xu, Xu, Xu, Xu, Xu, Xu, Xu, Xu, Xu, Xu, Xu, Xu, Xu, Xu, Xu, Xu, Xu, Xu, Xu, Xu, Xu, Xu, Xu, Xu, Xu, Xu, Xu, Xu, Xu, Xu, Xu, Xu, Xu
